111111111111111111111111111111111
1P0000000000000000000000000000001
100000001111100000011111000000001
100000011111100000111111100000001
100000110001100001100C01100000001
100001100001100000000011000000001
100011111011100000000110000000001
100111111C11100000001100000000001
1000000000111000000110C0000000001
100000000011100000111111000000001
1000000000000000000000000000000E1
111111111111111111111111111111111