1111111
1EC0P11
1001111
1C01C11
1111111