1111111111
1P00C00001
1111111101
111111E001
1111111111